100000000000000000000011
111101111110111111111110
000000000000000000000000
011110111111101110111110
010000000001101110100000
000011111100000000001110
111000000001111101111010
001010101010000000000000
001010101001001111101011
010010100000100000101000
010010010000010000101000
010010001000001000101000
01001000-1100000111101101
010000000000000100000000
001000000000100100000000
000100000000000111011111
000001000010001000000000
000100000000100010000000
000001001000010000010000
000100000010000010000000
000000000000000000000001